grid:
0|0|0|0|0|0|0|0|0|0|0|0|0|0|0|0|0|0|0|0
0|0|0|0|2|2|2|2|2|0|0|0|0|0|0|0|0|0|0|0
0|2|2|2|2|1|1|1|2|0|0|0|0|0|0|0|0|0|0|0
0|2|1|3|1|3|1|1|2|0|0|0|0|0|0|0|0|0|0|0
0|2|1|1|1|3|1|1|2|0|0|0|0|0|0|0|0|0|0|0
0|2|5|5|5|2|2|2|2|0|0|0|0|0|0|0|0|0|0|0
0|2|2|2|2|2|0|0|0|0|0|0|0|0|0|0|0|0|0|0
0|0|0|0|0|0|0|0|0|0|0|0|0|0|0|0|0|0|0|0
0|0|0|0|0|0|0|0|0|0|0|0|0|0|0|0|0|0|0|0
0|0|0|0|0|0|0|0|0|0|0|0|0|0|0|0|0|0|0|0
0|0|0|0|0|0|0|0|0|0|0|0|0|0|0|0|0|0|0|0
0|0|0|0|0|0|0|0|0|0|0|0|0|0|0|0|0|0|0|0
0|0|0|0|0|0|0|0|0|0|0|0|0|0|0|0|0|0|0|0
0|0|0|0|0|0|0|0|0|0|0|0|0|0|0|0|0|0|0|0
0|0|0|0|0|0|0|0|0|0|0|0|0|0|0|0|0|0|0|0
0|0|0|0|0|0|0|0|0|0|0|0|0|0|0|0|0|0|0|0
0|0|0|0|0|0|0|0|0|0|0|0|0|0|0|0|0|0|0|0
0|0|0|0|0|0|0|0|0|0|0|0|0|0|0|0|0|0|0|0
0|0|0|0|0|0|0|0|0|0|0|0|0|0|0|0|0|0|0|0
0|0|0|0|0|0|0|0|0|0|0|0|0|0|0|0|0|0|0|0
name: Roundabout
playerstart: 4|5
